#########E####
# # ## ## ####
# # ## ## ####
#            #
##### # # ####
##### # # ####
#S           #
##############