######################
#E#########S##########
# ########  ######## #
# ####     ######### #
# ######## #### #### #
# ######## #### #### #
#                    #
######################